11111111111111111111111111111111111111111111111111111111111111111
10000001011E0000000000100C0C00100000000C100P001000100100000000C01
100010010C1010100000000100000C001010000010C011001C000010000001001
10000000000000100100000C0010C10C00010100C0C0C00010000001000100101
11000001000C0000C11000000C00010C0100010000C0000000C1000100C000011
100011C00C0C0C0010000C0000001001100C0000010C000CC01000C0001001001
1010C0C100100000010000000C0000C1000000CC0C1000C00C100000000110101
1100100C001000010010100001001C001C11C0C100100010C000C00C001010111
11011010101000000010100110000000010000001000100000C000010101000C1
100000100001000C00C001000010000000011C000000C1100C010C00000100011
101101000100100C100111000C0000000000000C0100001000000C10C0000CC01
100010001000100000CCC0100010110000100011000000C000000000100000001
10000000C1110010C0010C00100100100C0000110C000010C0000000C00100001
111C000000000C10001000C011C10001001001000100111001101C01C0100C001
101100010C0C00100C0010011C10000010000000010C00000C011001C0C010101
10C10001000010C1000C00C0000001C00C000000000000100000000C0C0000001
1000001000001CC000CC0011000000000000000000101C0011000000100000001
1010000C1000CC0010001C01100010001000110C0000010CC00C0011CCCCC0CC1
1000000011C001C000100000001010011C000010C10010000001C000000C000C1
1000C00CC0000000CC10001C0000010100000000C0001C100100C100000C0C101
11111111111111111111111111111111111111111111111111111111111111111
