11111111111111111111111111111111111111111111111111111111111111111111111111
11010C000100C000110110000100010C100000P1010001000000010CC0000C100C00010C01
111010010C0001000010000000000C0010CC011110000000C0000010C01100000000000001
111100101000100C0C1000100100000010C001010000011001110C01C111C0010000011001
10C001110110C000C0001000110000000C1110011001C10C000C00110000C01000000C0011
100100C1C0C10C0C0001000C0000110000001101000010110000000010C00100C011C010C1
1011C0000010C001000C0C01001001000000C000C00C10C0000C10C00CC0001100001010C1
100010000000000C010C00C0C10000000000C000000000000100000000C1000000C0001001
11C000000100000CC000010100C01010C000C0C000C1C00010C0000CC00010011001000001
110001C0001110CC0000C0010C0010000C00C0C0010000110C001000100101000000000111
10100100C1C00010E00100001C00C001C00000C0C0C1010C001000C001000000000C0010C1
1C00C0001000001001C10111C0C01C0C0000CC11010000100000100000C0C1100000000001
1101C00010C1C001001001010C000100000C000000000000C00000000000C000C010100001
11111111111111111111111111111111111111111111111111111111111111111111111111
